####################
[XXXXXXX@@@@@@@@@@@]
[XXXXXXX@@@@@@@@@@@]
[XXXXXXX@@@@@@@@@@@]
[XXXXXXX@@@@@@@@@@@]
[XXXXXXX@@@@@@@@@@@]
[XXXXXXX@@@@@@@@@@@]
[XXXXXXX@@@@@@@@@@@]
[@@@@@@@@@@@@@@@@@@]
[@@@@@@@@@@@@@@@@@@D
[@@@@@@@@@@@@@@@@@@D
[@@@@@@@@@@@@@@@@@@]
[@@@@@@@@@@@XXXXXXX]
[@@@@@@@@@@@XXXXXXX]
[@@@@@@@@@@@XXXXXXX]
[@@@@@@@@@@@XXXXXXX]
[@@@@@@@@@@@XXXXXXX]
[@@@@@@@@@@@XXXXXXX]
[@@@@@@@@@@@XXXXXXX]
#########SS#########