#########WW#########
[XXXXXXX@@@@XXXXXXX]
[XXXXXXX@@@@XXXXXXX]
[XXXXXXX@@@@XXXXXXX]
[XXXXXXX@@@@XXXXXXX]
[XXXXXXX@@@@XXXXXXX]
[XXXXXXX@@@@XXXXXXX]
[XXXXXXX@@@@XXXXXXX]
[XXXXXX@@@@@@XXXXXX]
[XXXXXX@@@@@@XXXXXX]
[XXXXXX@@@@@@XXXXXX]
[XXXXXX@@@@@@XXXXXX]
[XXXXXX@@@@@@XXXXXX]
[XXXXXXXXXXXXXXXXXX]
[XXXXXXXXXXXXXXXXXX]
[XXXXXXXXXXXXXXXXXX]
[XXXXXXXXXXXXXXXXXX]
[XXXXXXXXXXXXXXXXXX]
[XXXXXXXXXXXXXXXXXX]
####################