#########WW#########
[@@@@@@@@@@@XXXXXXX]
[@@@@@@@@@@@XXXXXXX]
[@@@@@@@@@@@XXXXXXX]
[@@@@@@XXXXXXXXXXXX]
[@@@@@@XXXXXXXXXXXX]
[@@@@@@XXXXXXXXXXXX]
[@@@@@@XXXXXXXXXXXX]
[@@@@@@XXXXXX@@@@@@]
[@@@@@@XXXXXX@@@@@@D
[@@@@@@XXXXXX@@@@@@D
[@@@@@@XXXXXX@@@@@@]
[@@@@@@XXXXXX@@@@@@]
[@@@@@@XXXXXX@@@@@@]
[@@@@@@XXXXXX@@@@@@]
[@@@@@@XXXXXX@@@@@@]
[@@@@@@XXXXXX@@@@@@]
[@@@@@@@@@@@@@@@@@@]
[@@@@@@@@@@@@@@@@@@]
####################