#########WW#########
[@@@@@@@@@@@XXXXXXX]
[@@@@@@@@@@@XXXXXXX]
[@@@@@@@@@@@XXXXXXX]
[@@@@@@@@@@@XXXXXXX]
[@@@@@@@@@@@XXXXXXX]
[@@@@@@@@@@@XXXXXXX]
[@@@@@@@@@@@XXXXXXX]
[@@@@@@@@@@@@@@@@@@]
[@@@@@@@@@@@@@@@@@@D
[@@@@@@@@@@@@@@@@@@D
[@@@@@@@@@@@@@@@@@@]
[XXXXXXXXXXXXXXXXXX]
[XXXXXXXXXXXXXXXXXX]
[XXXXXXXXXXXXXXXXXX]
[XXXXXXXXXXXXXXXXXX]
[XXXXXXXXXXXXXXXXXX]
[XXXXXXXXXXXXXXXXXX]
[XXXXXXXXXXXXXXXXXX]
####################