#########WW#########
[XXXXXXX@@@@XXXXXXX]
[XXXXXXX@@@@XXXXXXX]
[XXXXXXX@@@@XXXXXXX]
[XXXXXXX@@@@XXXXXXX]
[XXXXXXX@@@@XXXXXXX]
[XXXXXXX@@@@XXXXXXX]
[XXXXXXX@@@@XXXXXXX]
[@@@@@@@@@@@XXXXXXX]
A@@@@@@@@@@@XXXXXXX]
A@@@@@@@@@@@XXXXXXX]
[@@@@@@@@@@@XXXXXXX]
[XXXXXXX@@@@XXXXXXX]
[XXXXXXX@@@@XXXXXXX]
[XXXXXXX@@@@XXXXXXX]
[XXXXXXX@@@@XXXXXXX]
[XXXXXXX@@@@XXXXXXX]
[XXXXXXX@@@@XXXXXXX]
[XXXXXXX@@@@XXXXXXX]
#########SS#########