#########WW#########
[@@@@@@@@@@@@@@@@@@]
[@@@@@@@@@@@@@@@@@@]
[@@@@@@@@@@@@@@@@@@]
[@@@XXXXXXXXXXXX@@@]
[@@@X@@@@@@@@@@X@@@]
[@@@X@@@@@@@@@@X@@@]
[@@@X@@@@@@@@@@@@@@]
[@@@X@@@@@@@@@@@@@@]
A@@@X@@@@@@@@@@@@@@]
A@@@X@@@@@@@@@@@@@@]
[@@@X@@@@@@@@@@@@@@]
[@@@X@@@@@@@@@@@@@@]
[@@@X@@@@@@@@@@X@@@]
[@@@X@@@@@@@@@@X@@@]
[@@@XXXXXXXXXXXX@@@]
[@@@@@@@@@@@@@@@@@@]
[@@@@@@@@@@@@@@@@@@]
[@@@@@@@@@@@@@@@@@@]
#########SS#########