#########WW#########
[XXXXXXX@@@@XXXXXXX]
[XXXXXXX@@@@XXXXXXX]
[XXXXXXX@@@@XXXXXXX]
[XXXXXXX@@@@XXXXXXX]
[XXXXXXX@@@@XXXXXXX]
[XXXXXXX@@@@XXXXXXX]
[XXXXXXX@@@@XXXXXXX]
[@@@@@@@@@@@@@@@@@@]
A@@@@@@@@@@@@@@@@@@D
A@@@@@@@@@@@@@@@@@@D
[@@@@@@@@@@@@@@@@@@]
[XXXXXXXXXXXXXXXXXX]
[XXXXXXXXXXXXXXXXXX]
[XXXXXXXXXXXXXXXXXX]
[XXXXXXXXXXXXXXXXXX]
[XXXXXXXXXXXXXXXXXX]
[XXXXXXXXXXXXXXXXXX]
[XXXXXXXXXXXXXXXXXX]
####################