####################
[@@@@@@@@@@@@@@@@@@]
[@@@@@@@@@@@@@@@@@@]
[@@@@@@@@@@@@@@@@@@]
[@@@@@@@@@@@@@@@@@@]
[@@@@XXXXX@@@XX@@@@]
[@@@@X@@@X@@@@X@@@@]
[@@@@X@@@X@@@@X@@@@]
[@@@@X@@@X@@@@X@@@@]
[@@@@X@@@X@@@@X@@@@]
[@@@@XXXXX@@@XXX@@@]
[@@@@@@@@@@@@@@@@@@]
[@@@@@@@@@@@@@@@@@@]
[@@@@@@@@@@@@@@@@@@]
[@@@@@@@@@@@@@@@@@@]
[@@@@@@@@@@@@@@@@@@]
[@@@@@@@@@@@@@@@@@@]
[@@@@@@@@@@@@@@@@@@]
[@@@@@@@@@@@@@@@@@@]
####################