##########X#########
[@@@@@@@@@X@@@@@@@@]
[@@@@@@@@@X@@@@@@@@]
[@@@@@@@@@X@@@@@@@@]
[@@@@@@@@@X@@@@@@@@]
[@@@@@@@@@X@@@@@@@@]
[@@@@@@@@@X@@@@@@@@]
[@@@@@@@@@XXXXXX@@@]
A@@@@@@@@@@@@@@X@@@D
A@@@@@@@@@@@@@@X@@@D
A@@@@@@@@@@@@@@@@@@D
[@@@@@@@@@@@@@@@@@@]
[@@@@@@@@@@@@@@@@@@]
[@@@@@@@@@@@@@@@@@@]
[@@@@@@@@@@@@@@@@@@]
[@@@@@@@@@@@@@@@@@@]
[@@@@@@@@@@@@@@@@@@]
[@@@@@@@@@@@@@@@@@@]
[@@@@@@@@@@@@@@@@@@]
#########SSS########