##########X#########
[@@@@@@@@@X@@@@@@@@]
[@@@@@@@@@X@@@@@@@@]
[@@@@@@@@@X@@@@@@@@]
[@@@@@@@@@X@@@@@@@@]
[@@@@@@@@@X@@@@@@@@]
[@@@@@@@@@X@@@@@@@@]
[@@@@@@@@@XXXXXX@@@]
D@@@@@@@@@@@@@@X@@@D
D@@@@@@@@@@@@@@X@@@D
D@@@@@@@@@@@@@@@@@@D
[@@@@@@@@@@@@@@@@@@]
[@@@@@@@@@@@@@@@@@@]
[@@@@@@@@@@@@@@@@@@]
[@@@@@@@@@@@@@@@@@@]
[@@@@@@@@@@@@@@@@@@]
[@@@@@@@@@@@@@@@@@@]
[@@@@@@@@@@@@@@@@@@]
[@@@@@@@@@@@@@@@@@@]
#########DDD########