##########X#########
[@@@@@@@@@X@@@@@@@@]
[@@@@@@@@@X@@@@@@@@]
[@@@@@@@@@X@@@@@@@@]
[@@@@@@@@@X@@@@@@@@]
[@@@@@@@@@X@@@@@@@@]
[@@@@@@@@@X@@@@@@@@]
[@@@@@@@@@XXXXXX@@@]
[@@@@@@@@@@@@@@X@@@]
[@@@@@@@@@@@@@@X@@@]
[@@@@@@@@@@@@@@@@@@]
[@@@@@@@@@@@@@@@@@@]
[@@@@@@@@@@@@@@@@@@]
[@@@@@@@@@@@@@@@@@@]
[@@@@@@@@@@@@@@@@@@]
[@@@@@@@@@@@@@@@@@@]
[@@@@@@@@@@@@@@@@@@]
[@@@@@@@@@@@@@@@@@@]
[@@@@@@@@@@@@@@@@@@]
####################