####################
[@@@@@@@@@@@@@@@@@@]
[@@@@@@@@@@@@@@@@@@]
[@@@@@@@@@@@@@@@@@@]
[@@@############@@@]
[@@@############@@@]
[@@@############@@@]
[@@@############@@@]
[@@@############@@@]
[@@@############@@@]
[@@@############@@@]
[@@@############@@@]
[@@@############@@@]
[@@@############@@@]
[@@@############@@@]
[@@@############@@@]
[@@@@@@@@@@@@@@@@@@]
[@@@@@@@@@@@@@@@@@@]
[@@@@@@@@@@@@@@@@@@]
####################