#########WW#########
[@@@@@@@@@@@@@@@@@@]
[@@@@@@@@@@@@@@@@@@]
[@@@@@@@@@@@@@@@@@@]
[@@@XXXXXXXXXXXX@@@]
[@@@XXXXXXXXXXXX@@@]
[@@@XXXXXXXXXXXX@@@]
[@@@XXXXXXXXXXXX@@@]
[@@@XXXXXXXXXXXX@@@]
A@@@XXXXXXXXXXXX@@@D
A@@@XXXXXXXXXXXX@@@D
[@@@XXXXXXXXXXXX@@@]
[@@@XXXXXXXXXXXX@@@]
[@@@XXXXXXXXXXXX@@@]
[@@@XXXXXXXXXXXX@@@]
[@@@XXXXXXXXXXXX@@@]
[@@@@@@@@@@@@@@@@@@]
[@@@@@@@@@@@@@@@@@@]
[@@@@@@@@@@@@@@@@@@]
#########SS#########