#########WW#########
[XXXXXXX@@@@XXXXXXX]
[XXXXXXX@@@@XXXXXXX]
[XXXXXXX@@@@XXXXXXX]
[XXXXXXX@@@@XXXXXXX]
[XXXXXXX@@@@XXXXXXX]
[XXXXXXX@@@@XXXXXXX]
[XXXXXXX@@@@XXXXXXX]
[XXXXXXX@@@@@@@@@@@]
[XXXXXXX@@@@@@@@@@@D
[XXXXXXX@@@@@@@@@@@D
[XXXXXXX@@@@@@@@@@@]
[XXXXXXX@@@@XXXXXXX]
[XXXXXXX@@@@XXXXXXX]
[XXXXXXX@@@@XXXXXXX]
[XXXXXXX@@@@XXXXXXX]
[XXXXXXX@@@@XXXXXXX]
[XXXXXXX@@@@XXXXXXX]
[XXXXXXX@@@@XXXXXXX]
#########SS#########