####################
[XXXXXXXXXXXXXXXXXX]
[XXXXXXXXXXXXXXXXXX]
[XXXXXXXXXXXXXXXXXX]
[XXXXXXXXXXXXXXXXXX]
[XXXXXXXXXXXXXXXXXX]
[XXXXXXXXXXXXXXXXXX]
[XXXXXXXXXXXXXXXXXX]
[@@@@@@@@@@@XXXXXXX]
A@@@@@@@@@@@XXXXXXX]
A@@@@@@@@@@@XXXXXXX]
[@@@@@@@@@@@XXXXXXX]
[XXXXXXX@@@@XXXXXXX]
[XXXXXXX@@@@XXXXXXX]
[XXXXXXX@@@@XXXXXXX]
[XXXXXXX@@@@XXXXXXX]
[XXXXXXX@@@@XXXXXXX]
[XXXXXXX@@@@XXXXXXX]
[XXXXXXX@@@@XXXXXXX]
#########SS#########