#########WW#########
[XXXXXXX@@@@XXXXXXX]
[XXXXXXX@@@@XXXXXXX]
[XXXXXXX@@@@XXXXXXX]
[XXXXXXX@@@@XXXXXXX]
[XXXXXXX@@@@XXXXXXX]
[XXXXXXX@@@@XXXXXXX]
[XXXXXXX@@@@XXXXXXX]
[@@@@@@@@@@@XXXXXXX]
A@@@@@@@@@@@XXXXXXX]
A@@@@@@@@@@@XXXXXXX]
[@@@@@@@@@@@XXXXXXX]
[XXXXXXXXXXXXXXXXXX]
[XXXXXXXXXXXXXXXXXX]
[XXXXXXXXXXXXXXXXXX]
[XXXXXXXXXXXXXXXXXX]
[XXXXXXXXXXXXXXXXXX]
[XXXXXXXXXXXXXXXXXX]
[XXXXXXXXXXXXXXXXXX]
####################