#########WW#########
[@@@@@@@@@@@@@@@@@@]
[@@@@@@@@@@@@@@@@@@]
[@@@@@@@@@@@@@@@@@@]
[@@@XXXXXXXXXXXX@@@]
[@@@XXXXXXXXXXXX@@@]
[@@@XXXXXXXXXXXX@@@]
[@@@XXXXXXXXXXXX@@@]
[@@@XXXXXXXXXXXX@@@]
A@@@XXXXXXXXXXXX@@@]
A@@@XXXXXXXXXXXX@@@]
[@@@XXXXXXXXXXXX@@@]
[@@@XXXXXXXXXXXX@@@]
[@@@XXXXXXXXXXXX@@@]
[@@@XXXXXXXXXXXX@@@]
[@@@XXXXXXXXXXXX@@@]
[@@@@@@@@@@@@@@@@@@]
[@@@@@@@@@@@@@@@@@@]
[@@@@@@@@@@@@@@@@@@]
####################