####################
[@@@@@@@@@@@@@@@@@@]
[@@@@##########@@@@]
[@@@@@@@@@@@@@@@@@@]
[@@@@##########@@@@]
[@@@@@@@@@@@@@@@@@@]
[@@@@@@@@@@@@@@@@@@]
[@@@@@@@@@@@@@@@@@@]
[@@@@@@@@@@@@@@@@@@]
[@@@@@@@@@@@@@@@@@@D
[@@@@@@@@@@@@@@@@@@D
[@@@@@@@@@@@@@@@@@@]
[@@@@@@@@@@@@@@@@@@]
[@@@@@@@@@@@@@@@@@@]
[@@@@@@@@@@@@@@@@@@]
[@@@@##########@@@@]
[@@@@@@@@@@@@@@@@@@]
[@@@@##########@@@@]
[@@@@@@@@@@@@@@@@@@]
####################