####################
[@@@@@@@@@@@@@@@@@@]
[@@@@@@@@@@@@@@@@@@]
[@@@@@@@@@@@@@@@@@@]
[@@@@@@@@@@@@@@@@@@]
[@@@@XXXXX@@@XX@@@@]
[@@@@X@@@X@@@@X@@@@]
[@@@@X@@@X@@@@X@@@@]
[@@@@X@@@X@@@@X@@@@D
[@@@@X@@@X@@@@X@@@@D
[@@@@XXXXX@@@XXX@@@D
[@@@@@@@@@@@@@@@@@@]
[@@@@@@@@@@@@@@@@@@]
[@@@@@@@@@@@@@@@@@@]
[@@@@@@@@@@@@@@@@@@]
[@@@@@@@@@@@@@@@@@@]
[@@@@@@@@@@@@@@@@@@]
[@@@@@@@@@@@@@@@@@@]
[@@@@@@@@@@@@@@@@@@]
########SSS#########