########WWW#########
[@@@@@@@@@@@@@@@@@@]
[@@@@@@@@@@@@@@@@@@]
[@@@@@@@@@@@@@@@@@@]
[@@@@@@@@@@@@@@@@@@]
[@@@@@@@@@@@@@@@@@@]
[@@@@@@X@@@@@@@@@@@]
[@@@@@@X@@@@@@@@@@@]
[@@@@@@X@@X@@@@@@@@D
[@@@@@@XXXXX@@@@@@@D
[@@@@@@@@@X@@@@@@@@D
[@@@@@@@@@@@@@@@@@@]
[@@@@@@@@@@@@@@@@@@]
[@@@@@@@@@@@@@@@@@@]
[@@@@@@@@@@@@@@@@@@]
[@@@@@@@@@@@@@@@@@@]
[@@@@@@@@@@@@@@@@@@]
[@@@@@@@@@@@@@@@@@@]
[@@@@@@@@@@@@@@@@@@]
########SSS#########