#########WWW########
[@@@@@@@@@@@@@@@@@@]
[@@@@@@@@@@@@@@@@@@]
[@@@@@@@@@@@@@@@@@@]
[@@@@@@@@@@@@@@@@@@]
[@@@@@@@XXXXX@@@@@@]
[@@@@@@@X@@@@@@@@@@]
[@@@@@@@XXXXX@@@@@@]
A@@@@@@@@@@@X@@@@@@D
A@@@@@@@@@@@X@@@@@@D
A@@@@@@@XXXXX@@@@@@D
[@@@@@@@@@@@@@@@@@@]
[@@@@@@@@@@@@@@@@@@]
[@@@@@@@@@@@@@@@@@@]
[@@@@@@@@@@@@@@@@@@]
[@@@@@@@@@@@@@@@@@@]
[@@@@@@@@@@@@@@@@@@]
[@@@@@@@@@@@@@@@@@@]
[@@@@@@@@@@@@@@@@@@]
#########SSS########