#########WWW########
[@@@@@@@@@@@@@@@@@@]
[@@@@@@@@@@@@@@@@@@]
[@@@@@@@@@@@@@@@@@@]
[@@@@@@@@@@@@@@@@@@]
[@@@@@@@XXXXX@@@@@@]
[@@@@@@@X@@@X@@@@@@]
[@@@@@@@XXXXX@@@@@@]
A@@@@@@@X@@@X@@@@@@D
A@@@@@@@X@@@X@@@@@@D
A@@@@@@@XXXXX@@@@@@D
[@@@@@@@@@@@@@@@@@@]
[@@@@@@@@@@@@@@@@@@]
[@@@@@@@@@@@@@@@@@@]
[@@@@@@@@@@@@@@@@@@]
[@@@@@@@@@@@@@@@@@@]
[@@@@@@@@@@@@@@@@@@]
[@@@@@@@@@@@@@@@@@@]
[@@@@@@@@@@@@@@@@@@]
####################