####################
[@@@@@@@@@@@@@@@@@@]
[@@@@@@@@@@@@@@@@@@]
[@@@@@@@@@@@@@@@@@@]
[@@@@@@@@@@@@@@@@@@]
[@@@XXXXXXXXXXXX@@@]
[@@@XX@@@@@@@@@X@@@]
[@@@XX@@@@@@@@@X@@@]
[@@@XX@@@@@@@@@@@@@]
A@@@XX@@@@@@@@@@@@@]
A@@@XX@@@@@@@@@@@@@]
[@@@XX@@@@@@@@@@@@@]
[@@@XX@@@@@@@@@X@@@]
[@@@XX@@@@@@@@@X@@@]
[@@@XXXXXXXXXXXX@@@]
[@@@@@@@@@@@@@@@@@@]
[@@@@@@@@@@@@@@@@@@]
[@@@@@@@@@@@@@@@@@@]
[@@@@@@@@@@@@@@@@@@]
####################